no,name,kor,eng,math,total,avg,rank,c_date
1,Vin,86,98,52,236,78,0,2024-04-09
2,Shelli,50,59,78,187,62,0,2024-04-09
3,Jeff,89,51,73,213,71,0,2024-04-02
4,Gregor,73,98,82,253,84,0,2024-04-04
5,Mirna,82,54,53,189,63,0,2024-04-01
6,Cassy,85,76,75,236,78,0,2024-04-09
7,Domeniga,67,92,65,224,74,0,2024-04-08
8,Nilson,83,78,69,230,76,0,2024-04-03
9,Sherilyn,93,57,58,208,69,0,2024-04-06
10,Mason,97,74,69,240,80,0,2024-04-03
11,Ansley,97,92,56,245,81,0,2024-04-01
12,Margette,54,62,93,209,69,0,2024-04-03
13,Pietro,73,57,72,202,67,0,2024-04-06
14,Joyce,93,70,94,257,85,0,2024-04-03
15,Phylys,57,51,76,184,61,0,2024-04-01
16,Darline,96,53,96,245,81,0,2024-04-04
17,Worthy,51,82,92,225,75,0,2024-04-09
18,Marsha,59,81,50,190,63,0,2024-04-03
19,Glenine,52,92,60,204,68,0,2024-04-07
20,Karlene,79,91,63,233,77,0,2024-04-05
21,Jerrie,86,87,70,243,81,0,2024-04-06
22,D'arcy,55,61,62,178,59,0,2024-04-09
23,Meaghan,93,88,89,270,90,0,2024-04-07
24,Arluene,93,75,84,252,84,0,2024-04-05
25,Kattie,78,77,80,235,78,0,2024-04-01
26,Lexine,89,92,77,258,86,0,2024-04-09
27,Kearney,75,98,93,266,88,0,2024-04-03
28,Dorelia,66,92,60,218,72,0,2024-04-02
29,Rochell,91,79,59,229,76,0,2024-04-08
30,Bastien,54,75,77,206,68,0,2024-04-05
31,Tamera,76,99,50,225,75,0,2024-04-03
32,Loralee,77,94,85,256,85,0,2024-04-02
33,Forster,78,52,86,216,72,0,2024-04-04
34,Bonni,81,73,89,243,81,0,2024-04-03
35,Keeley,78,81,77,236,78,0,2024-04-01
36,Earlie,74,67,53,194,64,0,2024-04-04
37,Pia,66,74,76,216,72,0,2024-04-09
38,Nataniel,93,75,59,227,75,0,2024-04-06
39,Chucho,83,94,69,246,82,0,2024-04-09
40,Nils,64,74,79,217,72,0,2024-04-03
41,Javier,86,63,79,228,76,0,2024-04-03
42,Aristotle,69,50,62,181,60,0,2024-04-01
43,Sile,53,83,82,218,72,0,2024-04-07
44,Jenifer,61,76,89,226,75,0,2024-04-05
45,Hyacinthe,66,78,86,230,76,0,2024-04-02
46,Hiram,78,58,96,232,77,0,2024-04-01
47,Archy,65,88,78,231,77,0,2024-04-03
48,Lorna,86,97,91,274,91,0,2024-04-07
49,Clari,69,72,88,229,76,0,2024-04-05
50,Jany,63,77,86,226,75,0,2024-04-06
51,Northrup,77,87,55,219,73,0,2024-04-09
52,Donavon,58,74,60,192,64,0,2024-04-06
53,Odille,58,72,77,207,69,0,2024-04-05
54,Esteban,61,79,65,205,68,0,2024-04-04
55,Gene,90,72,75,237,79,0,2024-04-02
56,Edythe,60,77,85,222,74,0,2024-04-01
57,Patty,67,64,93,224,74,0,2024-04-01
58,Francisca,95,77,74,246,82,0,2024-04-01
59,Armstrong,54,74,66,194,64,0,2024-04-05
60,Benji,52,80,95,227,75,0,2024-04-07
61,Silvain,62,60,82,204,68,0,2024-04-02
62,Mohandas,50,81,86,217,72,0,2024-04-02
63,Dulce,50,56,61,167,55,0,2024-04-08
64,Bo,60,100,54,214,71,0,2024-04-02
65,Francois,88,69,92,249,83,0,2024-04-01
66,Illa,50,71,56,177,59,0,2024-04-01
67,Lesly,78,58,77,213,71,0,2024-04-08
68,Christophorus,71,90,100,261,87,0,2024-04-03
69,Kevina,98,98,66,262,87,0,2024-04-01
70,Pattie,80,54,52,186,62,0,2024-04-07
71,Shauna,88,74,69,231,77,0,2024-04-05
72,Bertie,57,51,95,203,67,0,2024-04-06
73,Nikolaos,71,75,85,231,77,0,2024-04-08
74,Cathi,63,58,88,209,69,0,2024-04-02
75,Birgit,85,82,93,260,86,0,2024-04-06
76,Claretta,71,99,75,245,81,0,2024-04-03
77,Travers,81,81,54,216,72,0,2024-04-07
78,Hermine,76,68,74,218,72,0,2024-04-04
79,Creighton,67,68,96,231,77,0,2024-04-03
80,Marcie,100,54,98,252,84,0,2024-04-03
81,Aristotle,77,54,99,230,76,0,2024-04-03
82,Imojean,91,89,96,276,92,0,2024-04-08
83,Raimundo,78,61,80,219,73,0,2024-04-05
84,Hugh,65,69,72,206,68,0,2024-04-02
85,Adah,64,64,96,224,74,0,2024-04-02
86,Thibaut,73,67,98,238,79,0,2024-04-08
87,Hughie,74,66,66,206,68,0,2024-04-01
88,Annabell,76,75,86,237,79,0,2024-04-02
89,Blanch,54,97,73,224,74,0,2024-04-01
90,Codee,53,60,57,170,56,0,2024-04-05
91,Glenden,71,82,93,246,82,0,2024-04-09
92,Thurstan,74,71,56,201,67,0,2024-04-01
93,Mayer,84,70,60,214,71,0,2024-04-02
94,Rhiamon,58,93,94,245,81,0,2024-04-04
95,Dusty,61,60,75,196,65,0,2024-04-02
96,Stesha,62,57,74,193,64,0,2024-04-05
97,Bartel,50,63,82,195,65,0,2024-04-02
98,Maurits,99,93,63,255,85,0,2024-04-04
99,Fanny,63,90,68,221,73,0,2024-04-05
100,Burnaby,76,51,86,213,71,0,2024-04-04
101,Braden,60,53,59,172,57,0,2024-04-03
102,Pepi,84,83,98,265,88,0,2024-04-02
103,Cathee,52,61,90,203,67,0,2024-04-07
104,Yanaton,73,53,95,221,73,0,2024-04-02
105,Beckie,54,55,53,162,54,0,2024-04-06
106,Brietta,90,75,71,236,78,0,2024-04-08
107,Yovonnda,55,90,69,214,71,0,2024-04-02
108,Kristoffer,97,100,89,286,95,0,2024-04-04
109,Cherie,72,93,76,241,80,0,2024-04-02
110,Lyssa,100,76,99,275,91,0,2024-04-09
111,Rea,67,82,65,214,71,0,2024-04-01
112,Licha,52,83,92,227,75,0,2024-04-07
113,Thia,67,92,82,241,80,0,2024-04-01
114,Otho,88,58,53,199,66,0,2024-04-04
115,Lora,56,97,60,213,71,0,2024-04-02
116,Milka,75,87,55,217,72,0,2024-04-08
117,Jade,88,52,85,225,75,0,2024-04-03
118,Melodee,88,51,99,238,79,0,2024-04-05
119,Jock,90,86,86,262,87,0,2024-04-08
120,Fonz,87,51,71,209,69,0,2024-04-01
121,Minni,93,61,91,245,81,0,2024-04-05
122,Greggory,88,95,92,275,91,0,2024-04-06
123,Conan,84,54,87,225,75,0,2024-04-02
124,Barclay,78,94,65,237,79,0,2024-04-04
125,Meir,63,53,63,179,59,0,2024-04-07
126,Larine,62,94,56,212,70,0,2024-04-02
127,Margette,54,82,78,214,71,0,2024-04-08
128,Heather,89,69,99,257,85,0,2024-04-08
129,Alanah,62,83,82,227,75,0,2024-04-02
130,Gordy,51,65,75,191,63,0,2024-04-09
131,Viviyan,63,85,64,212,70,0,2024-04-04
132,Olivette,63,68,71,202,67,0,2024-04-04
133,Jania,73,60,53,186,62,0,2024-04-07
134,Leo,57,81,50,188,62,0,2024-04-08
135,Sianna,92,54,76,222,74,0,2024-04-02
136,Bondie,66,76,65,207,69,0,2024-04-09
137,Melodie,88,57,64,209,69,0,2024-04-08
138,Valaria,97,64,81,242,80,0,2024-04-02
139,Benito,50,100,50,200,66,0,2024-04-09
140,Lorna,62,93,64,219,73,0,2024-04-06
141,Petronia,75,97,84,256,85,0,2024-04-03
142,Salim,87,85,64,236,78,0,2024-04-07
143,Far,82,55,58,195,65,0,2024-04-09
144,Liza,57,62,68,187,62,0,2024-04-04
145,Starla,56,88,97,241,80,0,2024-04-09
146,Karisa,53,84,57,194,64,0,2024-04-09
147,Kaspar,94,83,57,234,78,0,2024-04-04
148,Abrahan,64,83,80,227,75,0,2024-04-02
149,Hugues,73,68,86,227,75,0,2024-04-04
150,Inesita,89,93,94,276,92,0,2024-04-08
151,Joella,55,68,63,186,62,0,2024-04-07
152,Lib,56,62,89,207,69,0,2024-04-06
153,Hercule,50,51,100,201,67,0,2024-04-02
154,Nonna,86,62,100,248,82,0,2024-04-01
155,Prince,51,99,70,220,73,0,2024-04-01
156,Hanna,50,51,91,192,64,0,2024-04-03
157,Idell,59,72,73,204,68,0,2024-04-06
158,Cirillo,75,61,80,216,72,0,2024-04-02
159,Jackie,66,92,55,213,71,0,2024-04-02
160,Yetty,54,85,59,198,66,0,2024-04-09
161,Tiffy,80,87,92,259,86,0,2024-04-08
162,Stacee,79,89,55,223,74,0,2024-04-07
163,Benjamen,88,89,86,263,87,0,2024-04-07
164,Clementina,94,53,98,245,81,0,2024-04-05
165,Rozanna,97,68,55,220,73,0,2024-04-09
166,Georgena,66,69,87,222,74,0,2024-04-07
167,Ursa,52,86,98,236,78,0,2024-04-04
168,Donni,57,53,94,204,68,0,2024-04-01
169,Martelle,88,52,50,190,63,0,2024-04-01
170,Brnaba,81,90,79,250,83,0,2024-04-07
171,Theresina,92,65,61,218,72,0,2024-04-06
172,Olympia,96,94,92,282,94,0,2024-04-06
173,Giulietta,50,69,89,208,69,0,2024-04-08
174,Rolando,74,78,87,239,79,0,2024-04-07
175,Petey,97,85,80,262,87,0,2024-04-07
176,Meggie,85,87,73,245,81,0,2024-04-06
177,Parker,92,100,65,257,85,0,2024-04-04
178,Kiah,55,95,51,201,67,0,2024-04-07
179,Darb,51,68,74,193,64,0,2024-04-01
180,Payton,58,58,56,172,57,0,2024-04-03
181,Jilleen,54,54,84,192,64,0,2024-04-08
182,Odelle,51,98,73,222,74,0,2024-04-09
183,Anitra,72,77,89,238,79,0,2024-04-02
184,Denys,54,63,93,210,70,0,2024-04-01
185,Ethyl,80,55,68,203,67,0,2024-04-02
186,Lusa,59,56,64,179,59,0,2024-04-03
187,Nickie,67,96,95,258,86,0,2024-04-04
188,Kerwinn,77,76,79,232,77,0,2024-04-04
189,Rocky,71,78,84,233,77,0,2024-04-02
190,Jazmin,87,65,82,234,78,0,2024-04-04
191,Horst,79,64,92,235,78,0,2024-04-07
192,Consolata,77,78,98,253,84,0,2024-04-05
193,Fredra,65,54,69,188,62,0,2024-04-01
194,Jodie,71,54,88,213,71,0,2024-04-09
195,Conni,97,62,75,234,78,0,2024-04-03
196,Clementia,86,50,94,230,76,0,2024-04-07
197,Ashlie,87,84,92,263,87,0,2024-04-06
198,Madge,52,54,59,165,55,0,2024-04-04
199,Anatola,83,60,94,237,79,0,2024-04-02
200,Genevra,80,89,74,243,81,0,2024-04-01
201,Allayne,86,53,81,220,73,0,2024-04-03
202,Neala,78,51,86,215,71,0,2024-04-05
203,Nannie,97,72,93,262,87,0,2024-04-02
204,Terza,77,68,67,212,70,0,2024-04-07
205,Bing,70,88,51,209,69,0,2024-04-06
206,Rosina,90,83,55,228,76,0,2024-04-02
207,Aurthur,74,92,73,239,79,0,2024-04-07
208,Cacilie,60,99,68,227,75,0,2024-04-02
209,Celle,80,89,62,231,77,0,2024-04-07
210,Pattie,59,50,63,172,57,0,2024-04-05
211,Karolina,99,51,75,225,75,0,2024-04-01
212,Roxine,85,84,78,247,82,0,2024-04-03
213,Ariella,52,74,70,196,65,0,2024-04-03
214,Estele,77,76,76,229,76,0,2024-04-05
215,Tadd,64,56,61,181,60,0,2024-04-06
216,Gui,79,90,83,252,84,0,2024-04-09
217,Aguistin,68,73,50,191,63,0,2024-04-01
218,Micheline,85,69,83,237,79,0,2024-04-01
219,Reg,95,91,90,276,92,0,2024-04-01
220,Ina,63,85,93,241,80,0,2024-04-07
221,Ebeneser,55,51,94,200,66,0,2024-04-04
222,Joanna,89,93,62,244,81,0,2024-04-03
223,Devy,90,100,53,243,81,0,2024-04-04
224,Mignon,70,50,84,204,68,0,2024-04-01
225,Yolane,93,51,77,221,73,0,2024-04-02
226,Buddie,61,63,73,197,65,0,2024-04-05
227,Lance,66,74,85,225,75,0,2024-04-07
228,Nickola,89,57,85,231,77,0,2024-04-09
229,Buiron,62,67,64,193,64,0,2024-04-02
230,Filippo,97,90,73,260,86,0,2024-04-01
231,Bertrand,78,65,94,237,79,0,2024-04-04
232,Grant,96,53,90,239,79,0,2024-04-04
233,Noland,88,67,61,216,72,0,2024-04-07
234,Royce,76,79,93,248,82,0,2024-04-06
235,Blanca,76,69,87,232,77,0,2024-04-06
236,Yale,67,91,93,251,83,0,2024-04-01
237,Carson,71,72,85,228,76,0,2024-04-08
238,Quintin,85,78,50,213,71,0,2024-04-09
239,Bailie,58,62,82,202,67,0,2024-04-02
240,Ninetta,91,76,64,231,77,0,2024-04-05
241,Jephthah,85,99,78,262,87,0,2024-04-07
242,Lil,100,57,75,232,77,0,2024-04-02
243,Renault,50,97,60,207,69,0,2024-04-07
244,Cullen,63,87,88,238,79,0,2024-04-08
245,Amanda,65,71,72,208,69,0,2024-04-09
246,Courtney,86,81,93,260,86,0,2024-04-04
247,Geri,51,84,51,186,62,0,2024-04-09
248,Dolorita,75,92,97,264,88,0,2024-04-05
249,Hubert,70,84,69,223,74,0,2024-04-08
250,Willa,88,70,98,256,85,0,2024-04-05
251,Devon,68,68,59,195,65,0,2024-04-08
252,Irving,73,59,76,208,69,0,2024-04-01
253,Rickard,74,83,52,209,69,0,2024-04-03
254,Shell,99,64,77,240,80,0,2024-04-04
255,Abrahan,85,66,61,212,70,0,2024-04-02
256,Chaddie,64,53,80,197,65,0,2024-04-01
257,Randie,60,96,75,231,77,0,2024-04-01
258,Graehme,70,84,76,230,76,0,2024-04-08
259,Jaime,82,53,90,225,75,0,2024-04-07
260,Dorella,83,63,71,217,72,0,2024-04-09
261,Alexandro,56,81,90,227,75,0,2024-04-03
262,Robena,87,83,75,245,81,0,2024-04-05
263,Britteny,69,57,69,195,65,0,2024-04-02
264,Gav,93,63,82,238,79,0,2024-04-03
265,Rhodie,97,92,76,265,88,0,2024-04-06
266,Britney,90,66,72,228,76,0,2024-04-03
267,Anatollo,82,85,85,252,84,0,2024-04-07
268,Sheffy,79,57,86,222,74,0,2024-04-09
269,Alec,58,61,94,213,71,0,2024-04-01
270,Jannel,88,86,83,257,85,0,2024-04-05
271,Emlynn,84,59,75,218,72,0,2024-04-06
272,Juana,90,83,72,245,81,0,2024-04-02
273,Lynn,63,51,94,208,69,0,2024-04-04
274,Pauly,89,68,81,238,79,0,2024-04-08
275,Nico,71,80,64,215,71,0,2024-04-05
276,Alasteir,50,80,74,204,68,0,2024-04-05
277,Ninnetta,79,86,71,236,78,0,2024-04-07
278,Celeste,99,98,58,255,85,0,2024-04-09
279,Sidonnie,66,66,76,208,69,0,2024-04-07
280,Mayor,92,98,55,245,81,0,2024-04-05
281,Georgie,57,58,75,190,63,0,2024-04-07
282,Jobey,97,82,99,278,92,0,2024-04-05
283,Stacy,88,68,70,226,75,0,2024-04-02
284,Lane,79,67,86,232,77,0,2024-04-04
285,Bonnee,67,58,81,206,68,0,2024-04-09
286,Tome,77,66,90,233,77,0,2024-04-09
287,Aldo,77,54,98,229,76,0,2024-04-03
288,Kayla,93,62,92,247,82,0,2024-04-09
289,Baldwin,84,50,96,230,76,0,2024-04-04
290,Lancelot,85,83,93,261,87,0,2024-04-03
291,Olwen,78,76,79,233,77,0,2024-04-09
292,Ralina,58,69,74,201,67,0,2024-04-01
293,Malinda,56,55,81,192,64,0,2024-04-06
294,Haskell,82,70,55,207,69,0,2024-04-09
295,Ange,93,81,86,260,86,0,2024-04-07
296,Ansel,98,92,67,257,85,0,2024-04-02
297,Abelard,87,98,85,270,90,0,2024-04-03
298,Nestor,52,86,90,228,76,0,2024-04-08
299,Legra,62,62,89,213,71,0,2024-04-03
300,Iggie,89,62,76,227,75,0,2024-04-01
301,Glory,96,95,67,258,86,0,2024-04-02
302,Penelopa,74,56,50,180,60,0,2024-04-03
303,Rickey,79,62,89,230,76,0,2024-04-08
304,Wolfgang,72,56,86,214,71,0,2024-04-07
305,Lorrin,84,81,62,227,75,0,2024-04-07
306,Sukey,73,73,99,245,81,0,2024-04-01
307,Constantina,68,56,76,200,66,0,2024-04-08
308,Meryl,69,87,77,233,77,0,2024-04-09
309,Whitney,100,88,65,253,84,0,2024-04-07
310,Reggis,63,91,77,231,77,0,2024-04-02
311,Rory,92,60,82,234,78,0,2024-04-09
312,Nelson,63,54,54,171,57,0,2024-04-09
313,Dolores,98,96,96,290,96,0,2024-04-09
314,Richy,79,75,56,210,70,0,2024-04-05
315,Corina,97,56,94,247,82,0,2024-04-01
316,Byron,90,84,88,262,87,0,2024-04-08
317,Desmund,65,75,60,200,66,0,2024-04-07
318,Drucie,73,92,98,263,87,0,2024-04-06
319,Brier,83,98,83,264,88,0,2024-04-08
320,Errick,82,60,70,212,70,0,2024-04-01
321,Temp,99,68,81,248,82,0,2024-04-04
322,Arleen,98,82,95,275,91,0,2024-04-02
323,Alida,67,98,64,229,76,0,2024-04-04
324,Ty,69,91,93,253,84,0,2024-04-01
325,Amii,90,65,89,244,81,0,2024-04-02
326,Karlene,95,89,83,267,89,0,2024-04-06
327,Catlin,98,73,67,238,79,0,2024-04-03
328,Rickey,72,95,93,260,86,0,2024-04-08
329,Fairfax,70,100,96,266,88,0,2024-04-09
330,Nona,81,51,55,187,62,0,2024-04-03
331,Ahmed,69,95,96,260,86,0,2024-04-01
332,Elianore,95,50,97,242,80,0,2024-04-01
333,Ronalda,77,63,59,199,66,0,2024-04-02
334,Errol,99,55,51,205,68,0,2024-04-03
335,Cynthea,67,75,55,197,65,0,2024-04-09
336,Ronnica,99,65,88,252,84,0,2024-04-02
337,Lucinda,97,51,55,203,67,0,2024-04-03
338,Octavius,55,82,71,208,69,0,2024-04-07
339,Tova,68,59,79,206,68,0,2024-04-08
340,Bert,80,50,74,204,68,0,2024-04-06
341,Elizabeth,89,65,93,247,82,0,2024-04-02
342,Daryn,64,97,99,260,86,0,2024-04-09
343,Clea,82,91,95,268,89,0,2024-04-03
344,Alan,74,99,57,230,76,0,2024-04-02
345,Carlo,58,88,53,199,66,0,2024-04-09
346,Carmina,96,56,95,247,82,0,2024-04-06
347,Ab,98,66,56,220,73,0,2024-04-06
348,Cirillo,98,80,63,241,80,0,2024-04-06
349,Teddy,97,87,67,251,83,0,2024-04-06
350,Lynnell,98,50,69,217,72,0,2024-04-03
351,Sherye,65,86,85,236,78,0,2024-04-03
352,Franciska,52,95,81,228,76,0,2024-04-03
353,Allan,52,66,86,204,68,0,2024-04-05
354,Van,78,82,58,218,72,0,2024-04-06
355,Cara,82,62,94,238,79,0,2024-04-01
356,Inger,82,100,97,279,93,0,2024-04-09
357,Georgetta,66,92,67,225,75,0,2024-04-01
358,Josie,76,62,85,223,74,0,2024-04-06
359,Gerome,52,80,85,217,72,0,2024-04-02
360,Nannette,67,97,77,241,80,0,2024-04-03
361,Whitby,62,77,94,233,77,0,2024-04-03
362,Padriac,98,71,64,233,77,0,2024-04-06
363,Vita,100,55,76,231,77,0,2024-04-06
364,Janelle,85,56,91,232,77,0,2024-04-01
365,Alana,76,60,68,204,68,0,2024-04-09
366,Joachim,91,90,76,257,85,0,2024-04-02
367,Liliane,91,69,73,233,77,0,2024-04-05
368,Caroline,64,50,98,212,70,0,2024-04-04
369,Riane,53,57,50,160,53,0,2024-04-04
370,Jdavie,60,90,76,226,75,0,2024-04-05
371,Viole,81,59,76,216,72,0,2024-04-02
372,Robyn,96,81,66,243,81,0,2024-04-02
373,Claudette,84,100,94,278,92,0,2024-04-04
374,Gabi,64,60,50,174,58,0,2024-04-09
375,Fianna,56,71,95,222,74,0,2024-04-06
376,Elizabeth,62,91,99,252,84,0,2024-04-09
377,Yancey,92,86,98,276,92,0,2024-04-08
378,Almira,55,50,67,172,57,0,2024-04-08
379,Heddi,54,85,98,237,79,0,2024-04-05
380,Lindsay,59,92,96,247,82,0,2024-04-07
381,Clayson,66,57,69,192,64,0,2024-04-03
382,Claresta,71,52,59,182,60,0,2024-04-06
383,Kirby,66,74,70,210,70,0,2024-04-03
384,Obed,99,67,87,253,84,0,2024-04-04
385,Leonanie,63,76,77,216,72,0,2024-04-02
386,Malachi,100,79,100,279,93,0,2024-04-02
387,Jacki,66,66,71,203,67,0,2024-04-01
388,Horatius,99,84,89,272,90,0,2024-04-01
389,Gabrielle,79,99,53,231,77,0,2024-04-04
390,Eben,56,78,62,196,65,0,2024-04-02
391,Rowen,61,73,84,218,72,0,2024-04-03
392,Silvan,91,99,71,261,87,0,2024-04-08
393,Shalom,100,61,98,259,86,0,2024-04-07
394,Pyotr,58,90,65,213,71,0,2024-04-06
395,Bail,52,51,71,174,58,0,2024-04-09
396,Juditha,87,97,58,242,80,0,2024-04-06
397,Jessamine,87,77,50,214,71,0,2024-04-07
398,Boone,56,90,82,228,76,0,2024-04-08
399,Corty,86,58,56,200,66,0,2024-04-09
400,Roxine,98,57,85,240,80,0,2024-04-05
401,Crista,71,86,86,243,81,0,2024-04-09
402,Abagail,84,76,77,237,79,0,2024-04-05
403,Rebeca,76,69,76,221,73,0,2024-04-09
404,Randene,69,79,69,217,72,0,2024-04-05
405,Cinda,93,72,94,259,86,0,2024-04-09
406,Maryann,52,57,78,187,62,0,2024-04-01
407,Brande,85,92,51,228,76,0,2024-04-03
408,Crista,68,52,88,208,69,0,2024-04-07
409,Mariska,58,71,72,201,67,0,2024-04-08
410,Orlan,89,68,87,244,81,0,2024-04-04
411,Allx,73,85,64,222,74,0,2024-04-06
412,Karrie,77,97,54,228,76,0,2024-04-09
413,Onfre,90,81,63,234,78,0,2024-04-06
414,Colver,68,98,79,245,81,0,2024-04-01
415,Moyra,84,70,77,231,77,0,2024-04-08
416,Carolus,69,84,97,250,83,0,2024-04-01
417,Ashlin,95,97,60,252,84,0,2024-04-01
418,Karylin,95,75,53,223,74,0,2024-04-08
419,Kerri,94,63,59,216,72,0,2024-04-09
420,Boone,93,64,73,230,76,0,2024-04-08
421,Skye,92,97,61,250,83,0,2024-04-02
422,Gabriello,52,53,64,169,56,0,2024-04-05
423,Babara,89,65,52,206,68,0,2024-04-03
424,Lena,55,60,94,209,69,0,2024-04-07
425,Skipton,72,62,55,189,63,0,2024-04-09
426,Jayson,84,76,88,248,82,0,2024-04-02
427,Liva,56,92,81,229,76,0,2024-04-04
428,Rutledge,76,91,99,266,88,0,2024-04-07
429,Orren,64,55,75,194,64,0,2024-04-04
430,Friedrick,70,66,58,194,64,0,2024-04-08
431,Willie,93,61,100,254,84,0,2024-04-04
432,Caz,79,63,68,210,70,0,2024-04-05
433,Sophie,71,53,79,203,67,0,2024-04-06
434,Shanda,91,87,74,252,84,0,2024-04-02
435,Rafaellle,67,94,58,219,73,0,2024-04-04
436,Costa,98,89,87,274,91,0,2024-04-06
437,Simon,65,54,96,215,71,0,2024-04-06
438,Kendell,69,76,59,204,68,0,2024-04-07
439,Winnie,71,88,52,211,70,0,2024-04-08
440,Missy,86,51,86,223,74,0,2024-04-03
441,Waite,96,50,52,198,66,0,2024-04-04
442,Venus,80,91,87,258,86,0,2024-04-09
443,Tresa,99,79,96,274,91,0,2024-04-04
444,Taddeusz,81,85,78,244,81,0,2024-04-09
445,Eugenia,89,62,100,251,83,0,2024-04-07
446,Barbee,93,100,62,255,85,0,2024-04-04
447,Tony,72,77,93,242,80,0,2024-04-04
448,Jarret,92,64,61,217,72,0,2024-04-07
449,Yasmeen,60,64,73,197,65,0,2024-04-02
450,Arvy,69,51,67,187,62,0,2024-04-03
451,Tate,68,56,63,187,62,0,2024-04-01
452,Olly,50,88,96,234,78,0,2024-04-01
453,Dara,86,94,58,238,79,0,2024-04-07
454,Shawna,95,98,84,277,92,0,2024-04-09
455,Wendye,52,75,60,187,62,0,2024-04-01
456,Conni,54,54,78,186,62,0,2024-04-07
457,Nicolis,92,86,74,252,84,0,2024-04-05
458,Helyn,78,79,74,231,77,0,2024-04-06
459,Lucine,73,91,64,228,76,0,2024-04-08
460,Kary,72,86,69,227,75,0,2024-04-02
461,Archibold,88,99,69,256,85,0,2024-04-09
462,Mateo,82,83,99,264,88,0,2024-04-04
463,Fayre,77,98,76,251,83,0,2024-04-01
464,Valentina,63,98,68,229,76,0,2024-04-07
465,Biddy,93,96,63,252,84,0,2024-04-07
466,Noland,95,75,64,234,78,0,2024-04-08
467,Faulkner,64,62,68,194,64,0,2024-04-05
468,Myrna,73,95,60,228,76,0,2024-04-03
469,Cointon,100,70,97,267,89,0,2024-04-02
470,Arabele,53,98,86,237,79,0,2024-04-09
471,Enriqueta,100,99,90,289,96,0,2024-04-07
472,Casar,91,83,73,247,82,0,2024-04-09
473,Gilbertine,93,54,66,213,71,0,2024-04-05
474,Kaspar,78,56,76,210,70,0,2024-04-02
475,Annette,93,87,73,253,84,0,2024-04-01
476,Clemente,87,75,92,254,84,0,2024-04-03
477,Elisha,97,52,66,215,71,0,2024-04-03
478,Karlens,91,68,70,229,76,0,2024-04-07
479,Brade,64,73,58,195,65,0,2024-04-02
480,Gideon,92,51,62,205,68,0,2024-04-02
481,Laurella,75,100,97,272,90,0,2024-04-07
482,Denyse,65,96,83,244,81,0,2024-04-08
483,Steffie,63,83,84,230,76,0,2024-04-02
484,Dorelle,87,51,66,204,68,0,2024-04-09
485,Jemmy,98,50,62,210,70,0,2024-04-06
486,Franciskus,59,65,81,205,68,0,2024-04-08
487,Bess,61,84,90,235,78,0,2024-04-07
488,Consuela,51,67,51,169,56,0,2024-04-01
489,Rockey,80,52,100,232,77,0,2024-04-07
490,Emelyne,73,81,74,228,76,0,2024-04-04
491,Wain,67,72,93,232,77,0,2024-04-05
492,Indira,67,94,62,223,74,0,2024-04-08
493,Haywood,53,90,90,233,77,0,2024-04-06
494,Emalee,92,65,72,229,76,0,2024-04-07
495,Bo,80,93,90,263,87,0,2024-04-09
496,Nerte,60,91,64,215,71,0,2024-04-02
497,Pammi,83,77,62,222,74,0,2024-04-04
498,Norine,78,59,69,206,68,0,2024-04-08
499,Marika,61,64,78,203,67,0,2024-04-01
500,Juieta,90,75,65,230,76,0,2024-04-07
501,Marina,99,58,89,246,82,0,2024-04-03
502,Kittie,96,52,90,238,79,0,2024-04-05
503,Quintus,82,70,89,241,80,0,2024-04-09
504,Margarette,84,57,68,209,69,0,2024-04-05
505,Iain,61,70,91,222,74,0,2024-04-01
506,Belita,55,64,95,214,71,0,2024-04-03
507,Erminia,89,54,89,232,77,0,2024-04-05
508,Perice,96,57,90,243,81,0,2024-04-08
509,Cointon,58,100,70,228,76,0,2024-04-01
510,Sanders,91,63,100,254,84,0,2024-04-06
511,Sim,77,84,55,216,72,0,2024-04-06
512,Zollie,53,55,67,175,58,0,2024-04-06
513,Jordon,90,83,76,249,83,0,2024-04-02
514,Ermina,95,92,74,261,87,0,2024-04-07
515,Hermine,95,67,100,262,87,0,2024-04-05
516,Mic,52,61,51,164,54,0,2024-04-09
517,Maribelle,91,68,83,242,80,0,2024-04-02
518,Sianna,89,88,55,232,77,0,2024-04-06
519,Orin,96,90,80,266,88,0,2024-04-09
520,Kliment,87,76,82,245,81,0,2024-04-09
521,Steffie,51,62,63,176,58,0,2024-04-02
522,Frank,98,79,73,250,83,0,2024-04-09
523,Jenni,84,70,76,230,76,0,2024-04-05
524,Laure,98,84,65,247,82,0,2024-04-07
525,Dawna,87,99,50,236,78,0,2024-04-03
526,Haley,87,57,61,205,68,0,2024-04-02
527,Annabal,63,97,88,248,82,0,2024-04-07
528,Lenore,79,84,100,263,87,0,2024-04-09
529,Cecil,58,71,93,222,74,0,2024-04-06
530,Mitchael,70,82,87,239,79,0,2024-04-05
531,Ruth,86,68,73,227,75,0,2024-04-03
532,Gerek,70,70,72,212,70,0,2024-04-07
533,Aksel,86,78,73,237,79,0,2024-04-04
534,Maudie,61,72,67,200,66,0,2024-04-05
535,Tamera,84,76,98,258,86,0,2024-04-06
536,Karina,59,96,80,235,78,0,2024-04-03
537,Thedric,76,57,73,206,68,0,2024-04-06
538,Lucio,94,99,55,248,82,0,2024-04-01
539,Corene,67,95,100,262,87,0,2024-04-01
540,Rozelle,71,58,79,208,69,0,2024-04-09
541,George,100,92,89,281,93,0,2024-04-07
542,Mavis,97,100,75,272,90,0,2024-04-01
543,Clarabelle,88,81,50,219,73,0,2024-04-08
544,Shandie,80,52,88,220,73,0,2024-04-02
545,Eloisa,92,61,99,252,84,0,2024-04-05
546,Darnall,89,93,91,273,91,0,2024-04-03
547,Louisette,68,73,57,198,66,0,2024-04-05
548,Judie,61,75,51,187,62,0,2024-04-07
549,Ad,64,87,65,216,72,0,2024-04-01
550,Shir,64,70,59,193,64,0,2024-04-05
551,Ediva,74,65,80,219,73,0,2024-04-09
552,Will,74,88,97,259,86,0,2024-04-09
553,Neall,89,60,64,213,71,0,2024-04-09
554,Cherianne,86,64,66,216,72,0,2024-04-07
555,Drake,64,64,61,189,63,0,2024-04-09
556,Gale,98,59,50,207,69,0,2024-04-01
557,Rana,68,87,81,236,78,0,2024-04-03
558,Siegfried,64,94,68,226,75,0,2024-04-08
559,Christos,60,58,91,209,69,0,2024-04-07
560,Dorella,74,96,67,237,79,0,2024-04-03
561,Ranee,100,60,64,224,74,0,2024-04-09
562,Billye,76,75,86,237,79,0,2024-04-07
563,Margi,61,80,57,198,66,0,2024-04-03
564,Dotti,76,68,79,223,74,0,2024-04-03
565,Irene,68,100,98,266,88,0,2024-04-05
566,Celina,63,75,88,226,75,0,2024-04-06
567,Rora,75,60,54,189,63,0,2024-04-03
568,Randene,63,57,70,190,63,0,2024-04-07
569,Bancroft,68,100,50,218,72,0,2024-04-06
570,Hortense,73,53,89,215,71,0,2024-04-08
571,Eadmund,73,66,83,222,74,0,2024-04-03
572,Joyce,96,89,98,283,94,0,2024-04-03
573,Val,54,61,98,213,71,0,2024-04-03
574,Gustavo,98,96,53,247,82,0,2024-04-02
575,Leyla,63,71,58,192,64,0,2024-04-08
576,Ira,80,85,88,253,84,0,2024-04-07
577,Bendick,82,78,100,260,86,0,2024-04-01
578,Aldo,67,95,73,235,78,0,2024-04-09
579,Noble,77,53,98,228,76,0,2024-04-04
580,Lorelle,96,53,61,210,70,0,2024-04-05
581,Hildagard,72,100,94,266,88,0,2024-04-04
582,Brendin,52,85,60,197,65,0,2024-04-07
583,Judy,76,99,50,225,75,0,2024-04-01
584,Caressa,100,90,83,273,91,0,2024-04-01
585,Trip,75,55,56,186,62,0,2024-04-08
586,Archibaldo,99,76,51,226,75,0,2024-04-03
587,Jo ann,95,100,82,277,92,0,2024-04-04
588,Henrietta,53,61,52,166,55,0,2024-04-07
589,Lenna,50,61,73,184,61,0,2024-04-01
590,Urson,91,65,89,245,81,0,2024-04-08
591,Tymothy,75,83,64,222,74,0,2024-04-06
592,Juieta,66,77,95,238,79,0,2024-04-08
593,Consalve,77,77,68,222,74,0,2024-04-02
594,Vere,71,85,70,226,75,0,2024-04-05
595,Chip,71,50,53,174,58,0,2024-04-03
596,Madelin,90,88,72,250,83,0,2024-04-04
597,Maximilianus,96,80,93,269,89,0,2024-04-01
598,Cody,83,82,69,234,78,0,2024-04-01
599,Elna,97,81,60,238,79,0,2024-04-03
600,Jermain,97,53,88,238,79,0,2024-04-05
601,Vivian,52,85,72,209,69,0,2024-04-03
602,Ulrick,79,66,68,213,71,0,2024-04-05
603,Helli,90,72,69,231,77,0,2024-04-03
604,Ronda,75,93,80,248,82,0,2024-04-07
605,Andrey,54,54,89,197,65,0,2024-04-04
606,Townsend,100,64,64,228,76,0,2024-04-08
607,Ruperta,83,59,64,206,68,0,2024-04-01
608,Madelyn,80,63,90,233,77,0,2024-04-09
609,Ferrell,71,50,56,177,59,0,2024-04-03
610,Symon,78,78,67,223,74,0,2024-04-08
611,Brooke,78,76,76,230,76,0,2024-04-05
612,Jory,94,78,90,262,87,0,2024-04-01
613,Elisha,98,62,98,258,86,0,2024-04-01
614,Sidoney,78,54,88,220,73,0,2024-04-01
615,Alastair,75,79,90,244,81,0,2024-04-07
616,Peder,100,54,50,204,68,0,2024-04-06
617,Thorsten,95,82,52,229,76,0,2024-04-07
618,Lucius,75,98,68,241,80,0,2024-04-07
619,Gaylor,74,75,69,218,72,0,2024-04-01
620,Goddard,66,89,65,220,73,0,2024-04-09
621,Phineas,79,63,96,238,79,0,2024-04-05
622,Daryn,93,59,62,214,71,0,2024-04-09
623,Wilt,69,63,59,191,63,0,2024-04-05
624,Hanni,87,76,81,244,81,0,2024-04-04
625,Shae,100,92,54,246,82,0,2024-04-08
626,Theresina,100,51,81,232,77,0,2024-04-06
627,Ainslee,53,98,60,211,70,0,2024-04-07
628,Tressa,58,94,70,222,74,0,2024-04-08
629,Sayre,89,86,53,228,76,0,2024-04-09
630,Rodrique,84,71,86,241,80,0,2024-04-05
631,Nicolas,86,92,61,239,79,0,2024-04-09
632,Morna,100,56,83,239,79,0,2024-04-02
633,Masha,78,86,67,231,77,0,2024-04-07
634,Dilan,68,53,53,174,58,0,2024-04-08
635,Tamarah,75,95,75,245,81,0,2024-04-08
636,Leroi,75,57,86,218,72,0,2024-04-02
637,Carlie,89,55,99,243,81,0,2024-04-06
638,Franky,54,84,79,217,72,0,2024-04-04
639,Rori,70,61,91,222,74,0,2024-04-05
640,Lorry,51,53,84,188,62,0,2024-04-04
641,Lyndell,94,96,63,253,84,0,2024-04-08
642,Teddy,97,84,95,276,92,0,2024-04-04
643,Courtnay,75,93,58,226,75,0,2024-04-03
644,Megen,86,50,70,206,68,0,2024-04-03
645,Bartholomeus,79,98,63,240,80,0,2024-04-01
646,Lusa,68,62,85,215,71,0,2024-04-01
647,Sonnie,99,89,89,277,92,0,2024-04-09
648,Rab,94,68,79,241,80,0,2024-04-07
649,Tabitha,88,98,88,274,91,0,2024-04-07
650,Vally,62,51,90,203,67,0,2024-04-08
651,Caddric,54,76,83,213,71,0,2024-04-06
652,De witt,87,73,81,241,80,0,2024-04-03
653,Georgeta,73,58,51,182,60,0,2024-04-02
654,Gina,72,61,70,203,67,0,2024-04-08
655,Margaret,71,61,87,219,73,0,2024-04-06
656,Ariel,91,68,89,248,82,0,2024-04-03
657,Anna-maria,81,71,70,222,74,0,2024-04-07
658,Harlen,92,54,80,226,75,0,2024-04-05
659,Pearle,59,64,87,210,70,0,2024-04-03
660,Arte,69,91,68,228,76,0,2024-04-03
661,Woodman,58,77,81,216,72,0,2024-04-07
662,Yehudi,75,91,60,226,75,0,2024-04-02
663,Pauly,93,54,55,202,67,0,2024-04-09
664,Farra,85,94,56,235,78,0,2024-04-05
665,Cody,88,96,64,248,82,0,2024-04-09
666,Gerick,75,79,86,240,80,0,2024-04-09
667,Else,83,82,81,246,82,0,2024-04-08
668,Dar,96,57,68,221,73,0,2024-04-06
669,Courtnay,64,99,82,245,81,0,2024-04-08
670,Angelina,58,84,71,213,71,0,2024-04-04
671,Beale,60,98,68,226,75,0,2024-04-05
672,Marya,89,55,74,218,72,0,2024-04-02
673,Arleta,86,90,62,238,79,0,2024-04-06
674,Lora,89,53,67,209,69,0,2024-04-08
675,Bari,85,82,81,248,82,0,2024-04-01
676,Maribel,97,88,67,252,84,0,2024-04-02
677,Karel,98,94,59,251,83,0,2024-04-09
678,Petronia,66,55,93,214,71,0,2024-04-06
679,Octavia,67,85,62,214,71,0,2024-04-06
680,Ulick,75,87,88,250,83,0,2024-04-04
681,Karleen,81,52,94,227,75,0,2024-04-08
682,Marice,65,95,56,216,72,0,2024-04-04
683,Annabelle,66,64,96,226,75,0,2024-04-09
684,Delbert,86,98,100,284,94,0,2024-04-03
685,Belita,70,88,52,210,70,0,2024-04-09
686,Kary,50,82,52,184,61,0,2024-04-08
687,Corrine,97,60,59,216,72,0,2024-04-06
688,Freddie,59,87,87,233,77,0,2024-04-03
689,Jeanelle,65,64,61,190,63,0,2024-04-04
690,Tarra,73,54,53,180,60,0,2024-04-02
691,Ephraim,68,70,93,231,77,0,2024-04-07
692,Pancho,72,87,69,228,76,0,2024-04-04
693,Dierdre,53,52,92,197,65,0,2024-04-02
694,Kellsie,69,77,97,243,81,0,2024-04-01
695,Franchot,75,55,57,187,62,0,2024-04-06
696,Audry,54,61,63,178,59,0,2024-04-02
697,Rupert,66,70,76,212,70,0,2024-04-01
698,Fedora,90,94,93,277,92,0,2024-04-08
699,Adrian,59,80,65,204,68,0,2024-04-02
700,Lisette,72,69,59,200,66,0,2024-04-03
701,Gilly,55,66,54,175,58,0,2024-04-07
702,Otho,96,77,81,254,84,0,2024-04-07
703,Effie,90,62,59,211,70,0,2024-04-05
704,Gus,57,57,53,167,55,0,2024-04-04
705,Cornelle,82,75,66,223,74,0,2024-04-06
706,Tudor,60,91,61,212,70,0,2024-04-02
707,Marge,100,53,68,221,73,0,2024-04-08
708,Jarrid,99,66,67,232,77,0,2024-04-09
709,Elisha,85,99,64,248,82,0,2024-04-04
710,Hill,78,87,72,237,79,0,2024-04-09
711,Phoebe,79,56,88,223,74,0,2024-04-01
712,Dionis,55,88,91,234,78,0,2024-04-06
713,Brina,100,68,81,249,83,0,2024-04-02
714,Isadore,100,79,95,274,91,0,2024-04-08
715,Paxton,90,97,83,270,90,0,2024-04-06
716,Teodor,66,55,52,173,57,0,2024-04-06
717,Mela,51,93,60,204,68,0,2024-04-05
718,Martha,62,60,79,201,67,0,2024-04-06
719,Sharon,92,64,90,246,82,0,2024-04-07
720,Karna,74,50,70,194,64,0,2024-04-08
721,Kamillah,76,57,55,188,62,0,2024-04-06
722,Taber,66,93,86,245,81,0,2024-04-02
723,Rutger,66,80,64,210,70,0,2024-04-09
724,Taryn,57,51,62,170,56,0,2024-04-04
725,Reg,50,58,50,158,52,0,2024-04-02
726,Barth,93,64,83,240,80,0,2024-04-08
727,Lon,71,74,70,215,71,0,2024-04-01
728,Linda,52,75,51,178,59,0,2024-04-07
729,Rafferty,62,58,78,198,66,0,2024-04-05
730,Gaelan,74,76,92,242,80,0,2024-04-08
731,Lira,100,83,67,250,83,0,2024-04-02
732,Mariam,81,58,56,195,65,0,2024-04-09
733,Hedvige,77,97,58,232,77,0,2024-04-08
734,Annnora,98,96,85,279,93,0,2024-04-02
735,Marcus,95,99,75,269,89,0,2024-04-05
736,Caresse,81,79,60,220,73,0,2024-04-03
737,Olivero,54,61,85,200,66,0,2024-04-01
738,Hettie,83,95,58,236,78,0,2024-04-02
739,Reuven,98,75,95,268,89,0,2024-04-08
740,Reagan,81,80,68,229,76,0,2024-04-09
741,Brittany,75,95,71,241,80,0,2024-04-01
742,Aili,60,70,73,203,67,0,2024-04-04
743,Cyrill,55,82,68,205,68,0,2024-04-01
744,Ingelbert,89,79,86,254,84,0,2024-04-02
745,Clyde,61,98,59,218,72,0,2024-04-09
746,Brian,82,62,84,228,76,0,2024-04-09
747,Larina,99,70,91,260,86,0,2024-04-05
748,Emeline,66,91,76,233,77,0,2024-04-05
749,Hildagard,89,95,58,242,80,0,2024-04-06
750,Sawyere,95,92,75,262,87,0,2024-04-04
751,Issy,88,66,68,222,74,0,2024-04-06
752,Maximilianus,98,99,63,260,86,0,2024-04-04
753,Taber,94,90,89,273,91,0,2024-04-05
754,Audry,82,69,100,251,83,0,2024-04-05
755,Hesther,91,80,95,266,88,0,2024-04-09
756,Lenard,67,62,63,192,64,0,2024-04-06
757,Link,53,59,80,192,64,0,2024-04-02
758,Kizzie,76,94,84,254,84,0,2024-04-02
759,Anabal,83,97,82,262,87,0,2024-04-06
760,Hedy,80,87,56,223,74,0,2024-04-04
761,Sarah,55,73,73,201,67,0,2024-04-03
762,Imelda,100,61,55,216,72,0,2024-04-06
763,Lorain,90,74,88,252,84,0,2024-04-07
764,Benedick,71,78,64,213,71,0,2024-04-05
765,Jolie,67,65,99,231,77,0,2024-04-02
766,Glory,96,68,62,226,75,0,2024-04-04
767,Lona,65,85,52,202,67,0,2024-04-07
768,Cammy,93,96,66,255,85,0,2024-04-05
769,Rhonda,62,88,100,250,83,0,2024-04-08
770,Myca,63,91,66,220,73,0,2024-04-07
771,Claiborn,67,73,62,202,67,0,2024-04-02
772,Marcelle,59,87,57,203,67,0,2024-04-03
773,Rossy,92,68,65,225,75,0,2024-04-07
774,Magda,67,91,73,231,77,0,2024-04-09
775,Wynn,72,82,78,232,77,0,2024-04-07
776,Midge,94,81,76,251,83,0,2024-04-06
777,Jase,59,98,78,235,78,0,2024-04-02
778,Tanitansy,69,96,80,245,81,0,2024-04-05
779,Nanette,89,52,65,206,68,0,2024-04-02
780,Elijah,79,77,82,238,79,0,2024-04-07
781,Elinore,64,84,84,232,77,0,2024-04-08
782,Shay,83,72,51,206,68,0,2024-04-05
783,Giuditta,95,53,50,198,66,0,2024-04-01
784,Egbert,87,54,66,207,69,0,2024-04-05
785,Piper,95,69,77,241,80,0,2024-04-04
786,Joleen,79,51,50,180,60,0,2024-04-02
787,Carroll,82,92,55,229,76,0,2024-04-05
788,Brandi,51,65,66,182,60,0,2024-04-04
789,Helen,93,76,62,231,77,0,2024-04-02
790,Christoffer,64,89,55,208,69,0,2024-04-06
791,Lynsey,53,65,65,183,61,0,2024-04-07
792,Tobi,89,60,74,223,74,0,2024-04-08
793,Aldric,70,71,62,203,67,0,2024-04-01
794,Jobyna,82,91,67,240,80,0,2024-04-02
795,Stanfield,61,50,72,183,61,0,2024-04-06
796,Hilde,87,58,80,225,75,0,2024-04-09
797,Chip,67,63,56,186,62,0,2024-04-07
798,Gaultiero,63,95,68,226,75,0,2024-04-04
799,Zolly,78,88,99,265,88,0,2024-04-09
800,Dag,76,90,86,252,84,0,2024-04-08
801,Fletcher,94,86,89,269,89,0,2024-04-07
802,Adriana,66,96,61,223,74,0,2024-04-03
803,Debra,71,100,68,239,79,0,2024-04-03
804,Tristam,86,67,65,218,72,0,2024-04-06
805,Ches,69,64,83,216,72,0,2024-04-07
806,Alisun,76,82,89,247,82,0,2024-04-04
807,Englebert,55,97,90,242,80,0,2024-04-05
808,Nancee,93,56,55,204,68,0,2024-04-04
809,Mikel,62,94,96,252,84,0,2024-04-06
810,Adel,64,65,56,185,61,0,2024-04-01
811,Sheelagh,68,82,64,214,71,0,2024-04-05
812,Garek,96,71,52,219,73,0,2024-04-03
813,Veda,51,68,88,207,69,0,2024-04-01
814,Darbie,56,90,54,200,66,0,2024-04-06
815,Billie,80,87,96,263,87,0,2024-04-03
816,Fidole,61,81,87,229,76,0,2024-04-09
817,Jakob,72,70,78,220,73,0,2024-04-01
818,Claribel,60,51,97,208,69,0,2024-04-09
819,Jeana,85,69,61,215,71,0,2024-04-02
820,Artur,75,74,87,236,78,0,2024-04-03
821,Tera,85,80,57,222,74,0,2024-04-02
822,Cordelie,69,64,56,189,63,0,2024-04-03
823,Eden,73,68,68,209,69,0,2024-04-07
824,Anatol,65,61,98,224,74,0,2024-04-06
825,Maryjane,68,93,52,213,71,0,2024-04-01
826,Harper,52,77,62,191,63,0,2024-04-07
827,Walton,97,55,68,220,73,0,2024-04-03
828,Merissa,59,81,62,202,67,0,2024-04-03
829,Jessee,94,98,84,276,92,0,2024-04-04
830,Ches,83,60,55,198,66,0,2024-04-06
831,Caresse,60,69,51,180,60,0,2024-04-09
832,Barnie,91,55,94,240,80,0,2024-04-02
833,Jeri,73,95,59,227,75,0,2024-04-02
834,Harriett,63,76,50,189,63,0,2024-04-05
835,Blaine,80,95,65,240,80,0,2024-04-01
836,Chicky,61,92,89,242,80,0,2024-04-09
837,Bambie,51,79,92,222,74,0,2024-04-03
838,Harriot,88,88,95,271,90,0,2024-04-01
839,Frazier,58,57,93,208,69,0,2024-04-01
840,Decca,56,81,72,209,69,0,2024-04-09
841,Heall,65,79,54,198,66,0,2024-04-05
842,Elysee,77,71,78,226,75,0,2024-04-08
843,Yoko,61,82,80,223,74,0,2024-04-06
844,Morrie,50,91,72,213,71,0,2024-04-06
845,Dirk,66,95,97,258,86,0,2024-04-01
846,Ivy,67,70,52,189,63,0,2024-04-06
847,Whittaker,97,86,55,238,79,0,2024-04-05
848,Cheri,74,73,99,246,82,0,2024-04-04
849,Lenci,50,51,74,175,58,0,2024-04-08
850,Adam,57,65,89,211,70,0,2024-04-08
851,Dolores,94,62,98,254,84,0,2024-04-08
852,Caty,83,60,77,220,73,0,2024-04-02
853,Donnajean,71,84,75,230,76,0,2024-04-05
854,Phillis,92,98,88,278,92,0,2024-04-05
855,Lorry,88,82,99,269,89,0,2024-04-04
856,Blanch,56,89,70,215,71,0,2024-04-06
857,Esme,97,55,85,237,79,0,2024-04-07
858,Bridget,93,55,77,225,75,0,2024-04-06
859,Holly-anne,69,61,100,230,76,0,2024-04-03
860,Lenette,66,57,88,211,70,0,2024-04-07
861,Cammi,89,57,90,236,78,0,2024-04-04
862,Blancha,78,84,76,238,79,0,2024-04-08
863,Rafaellle,93,88,93,274,91,0,2024-04-08
864,Kliment,99,52,92,243,81,0,2024-04-09
865,Derril,98,77,85,260,86,0,2024-04-07
866,Shirlee,93,89,55,237,79,0,2024-04-01
867,Farlie,91,60,56,207,69,0,2024-04-05
868,Reese,63,52,66,181,60,0,2024-04-02
869,Daren,67,56,58,181,60,0,2024-04-09
870,Hendrick,93,53,100,246,82,0,2024-04-04
871,Prinz,87,70,93,250,83,0,2024-04-01
872,Madeleine,90,65,67,222,74,0,2024-04-01
873,Codi,81,74,77,232,77,0,2024-04-06
874,Hyacinthie,68,97,63,228,76,0,2024-04-07
875,Ermin,62,90,80,232,77,0,2024-04-04
876,Reid,87,95,59,241,80,0,2024-04-01
877,Galina,63,69,52,184,61,0,2024-04-08
878,Consuelo,56,75,73,204,68,0,2024-04-02
879,Marita,70,97,75,242,80,0,2024-04-01
880,Ambrose,61,99,51,211,70,0,2024-04-04
881,Derby,66,94,64,224,74,0,2024-04-09
882,Derrik,58,81,58,197,65,0,2024-04-09
883,Ronnica,72,81,79,232,77,0,2024-04-06
884,Amalita,77,96,97,270,90,0,2024-04-08
885,Mela,93,94,89,276,92,0,2024-04-06
886,Madeleine,69,54,72,195,65,0,2024-04-07
887,Coop,100,76,52,228,76,0,2024-04-04
888,Brynn,79,95,53,227,75,0,2024-04-03
889,Aeriel,70,68,54,192,64,0,2024-04-07
890,Urbano,56,78,79,213,71,0,2024-04-01
891,Greer,74,99,74,247,82,0,2024-04-09
892,Stacie,90,65,84,239,79,0,2024-04-02
893,Wolfie,92,95,77,264,88,0,2024-04-07
894,Brittne,65,60,84,209,69,0,2024-04-05
895,Lynelle,64,86,66,216,72,0,2024-04-06
896,Clyve,75,55,89,219,73,0,2024-04-08
897,Shir,94,67,73,234,78,0,2024-04-06
898,Booth,78,69,58,205,68,0,2024-04-03
899,Arlena,76,94,95,265,88,0,2024-04-09
900,Dwayne,100,83,81,264,88,0,2024-04-08
901,Benjamen,99,52,93,244,81,0,2024-04-04
902,Langston,70,85,84,239,79,0,2024-04-02
903,Caressa,91,94,64,249,83,0,2024-04-03
904,Corbin,87,79,68,234,78,0,2024-04-05
905,Stefanie,79,96,99,274,91,0,2024-04-09
906,Petra,100,54,96,250,83,0,2024-04-06
907,Maryann,65,96,95,256,85,0,2024-04-06
908,Elke,53,93,65,211,70,0,2024-04-02
909,Lonny,86,65,74,225,75,0,2024-04-04
910,Wood,51,59,73,183,61,0,2024-04-02
911,Nev,96,52,88,236,78,0,2024-04-08
912,Jean,90,72,80,242,80,0,2024-04-09
913,Evangelina,72,52,91,215,71,0,2024-04-02
914,Coreen,95,90,50,235,78,0,2024-04-07
915,Freddy,99,81,83,263,87,0,2024-04-09
916,Lora,91,81,89,261,87,0,2024-04-09
917,Sadella,60,75,63,198,66,0,2024-04-03
918,Delia,75,80,63,218,72,0,2024-04-04
919,Carolan,62,80,85,227,75,0,2024-04-04
920,Verge,86,75,70,231,77,0,2024-04-07
921,Gertruda,92,91,95,278,92,0,2024-04-08
922,Rosemary,57,72,71,200,66,0,2024-04-04
923,Bruis,77,60,86,223,74,0,2024-04-02
924,Bill,89,85,87,261,87,0,2024-04-08
925,Janey,83,98,61,242,80,0,2024-04-04
926,Maggie,78,95,84,257,85,0,2024-04-09
927,Brandie,83,69,94,246,82,0,2024-04-02
928,Charisse,84,54,98,236,78,0,2024-04-09
929,Fifi,68,82,72,222,74,0,2024-04-01
930,Dan,89,88,86,263,87,0,2024-04-04
931,Wilton,92,66,62,220,73,0,2024-04-02
932,Dian,88,93,99,280,93,0,2024-04-07
933,Wilow,55,76,81,212,70,0,2024-04-04
934,Niall,85,63,68,216,72,0,2024-04-04
935,Iorgos,89,63,76,228,76,0,2024-04-08
936,Celle,64,85,69,218,72,0,2024-04-03
937,Nikki,57,86,91,234,78,0,2024-04-05
938,Shea,75,52,66,193,64,0,2024-04-05
939,Katharyn,76,55,100,231,77,0,2024-04-06
940,Lenee,74,57,93,224,74,0,2024-04-03
941,Kimmy,81,67,88,236,78,0,2024-04-06
942,Jecho,59,74,58,191,63,0,2024-04-01
943,Farrell,85,98,57,240,80,0,2024-04-01
944,Wallache,75,92,89,256,85,0,2024-04-03
945,Caterina,92,64,80,236,78,0,2024-04-06
946,Germaine,88,55,99,242,80,0,2024-04-06
947,Jerome,96,57,59,212,70,0,2024-04-05
948,Anselma,66,50,79,195,65,0,2024-04-07
949,Wilhelmine,57,63,71,191,63,0,2024-04-04
950,Cosetta,70,96,75,241,80,0,2024-04-08
951,Isadora,90,78,58,226,75,0,2024-04-09
952,Gene,57,79,89,225,75,0,2024-04-04
953,Vinny,51,56,95,202,67,0,2024-04-02
954,Loren,54,63,82,199,66,0,2024-04-05
955,Siegfried,70,84,100,254,84,0,2024-04-02
956,Krysta,70,79,58,207,69,0,2024-04-04
957,Emma,55,72,77,204,68,0,2024-04-02
958,Gilburt,50,66,92,208,69,0,2024-04-09
959,Kennith,51,83,55,189,63,0,2024-04-03
960,Winston,69,72,75,216,72,0,2024-04-08
961,Codie,79,100,74,253,84,0,2024-04-07
962,Dennie,77,70,99,246,82,0,2024-04-03
963,Rozamond,70,99,90,259,86,0,2024-04-01
964,Rhianna,81,78,75,234,78,0,2024-04-09
965,Shelley,65,55,91,211,70,0,2024-04-04
966,Mab,51,94,79,224,74,0,2024-04-04
967,Benjamin,89,72,97,258,86,0,2024-04-04
968,Osborn,74,82,51,207,69,0,2024-04-07
969,Joelie,85,70,83,238,79,0,2024-04-06
970,Hort,80,91,75,246,82,0,2024-04-09
971,Lamont,57,90,74,221,73,0,2024-04-03
972,Millicent,80,66,60,206,68,0,2024-04-04
973,Trefor,62,51,96,209,69,0,2024-04-07
974,Julienne,94,99,85,278,92,0,2024-04-02
975,Gordan,86,78,58,222,74,0,2024-04-02
976,Fay,68,84,75,227,75,0,2024-04-03
977,Ivor,84,65,78,227,75,0,2024-04-05
978,Debby,86,73,62,221,73,0,2024-04-08
979,Nealon,93,87,97,277,92,0,2024-04-02
980,Kyrstin,62,75,89,226,75,0,2024-04-06
981,Nike,63,54,65,182,60,0,2024-04-04
982,Raleigh,82,65,75,222,74,0,2024-04-07
983,Berkeley,75,62,53,190,63,0,2024-04-07
984,Lorry,66,95,58,219,73,0,2024-04-07
985,Cliff,85,73,86,244,81,0,2024-04-05
986,Andras,73,96,53,222,74,0,2024-04-07
987,Elsinore,91,80,72,243,81,0,2024-04-01
988,Guinevere,69,87,68,224,74,0,2024-04-04
989,Heloise,96,56,97,249,83,0,2024-04-08
990,Willette,86,82,59,227,75,0,2024-04-01
991,Alfie,97,93,88,278,92,0,2024-04-06
992,Darda,53,76,65,194,64,0,2024-04-09
993,Donnamarie,70,59,93,222,74,0,2024-04-01
994,Jimmy,89,59,76,224,74,0,2024-04-04
995,Ernaline,74,78,50,202,67,0,2024-04-03
996,Cherianne,87,55,59,201,67,0,2024-04-08
997,Micheal,74,90,100,264,88,0,2024-04-09
998,Bernadette,90,88,88,266,88,0,2024-04-09
999,Quentin,85,76,66,227,75,0,2024-04-03
1000,Morey,56,91,100,247,82,0,2024-04-09
